	  NO texture/sludge.xpm


          EA texture/yellow.xpm


SO   texture/warn.xpm
WE  	  texture/blue.xpm
			F 150,15,1

    C 	   1,15,150
11111
10001
10N01
10001
11111

