NO texture/sludge.xpm
EA texture/yellow.xpm
SO texture/warn.xpm
WE texture/blue.xpm
F 100,100,100
C 0,128,128
11111
10001
10N01
10W01
11111
